**********
*21111111*
*11111111*
*11111111*
****11111*
*31*11111*
*11****41*
*4***111**
*11111111*
**********
