********
*11*21**
*11*111*
**31411*
********
