**********
******111*
**111*1*1*
**1*111*1*
**11****1*
*3*11*2*1*
*1**1*1*1*
*1**1*111*
*1111*****
**********
