AAAAAAAAAAAAAAAAA
ADLLLLLLLLLLLLLJA
AHPPPPPPPPPPPPPNA
AHPPPPPPPPPPPPPNA
AHPPPPPPPPPPPPPNA
AHPPPPPPPPPPPPPNA
AHPPPPPPPPPPPPPNA
AHPPPPPPPPPPPPPNA
AHPPPPPPPPPPPPPNA
AHPPPPPPPPPPPPPNA
AHPPPPPPPPPPPPPNA
AHPPPPPPPPPPPPPNA
AHPPPPPPPPPPPPPNA
AHPPPPPPPPPPPPPNA
AHPPPPPPPPPPPPPNA
AGOOOOOOOOOOOOOMA
AAAAAAAAAAAAAAAAA
