**********
*11111111*
*11111111*
*11111111*
*11111111*
*11111111*
*1*111111*
*1*111****
*1*111112*
**********
