**********
*31111111*
*11111111*
*11111111*
*11111111*
*11111111*
*1*111111*
*1*11*****
*1*111121*
**********
