*********
*11******
*11******
*13*11***
*1*111***
*4414****
*11*1142*
****1111*
*********
